NO textures/
SO textures/archivo.xpm
WE textures/archivo.xpm
EA textures/archivo.xpm

F 184,113,39
C 51,198,227

111111
100101
101001
1100N1
111111